╔══════╗                ╔═╗                 ╔═╝-╚═╗
║      ║                ║ ║                 ║     ║
║      ║             ╔══╝ ╚═╗               ╚═╗  ╔╝
╚═╗  ╔═╝ ╔══════════╗╚══╗ ╔═╝ ╔══════════╗  ╔═╝  ╚════════╗
╔═╝  ╚═╗ ║          ╚═══╝ ╚═══╝          ╚══╝             ╚
╝      ╚═╝                                                [
]                   ╔╗       ╔╗          ╔═╗              ╔
╗      ╔═╗          ║╚╗      ║╚══════════╝ ╚╗  ╔══════════╝
╚═╗  ╔═╝ ╚══════════╝ ╚═╗  ╔═╝            ╔═╝  ╚══╗
╔═╝  ╚═╗             ╔══╝  ╚══╗           ║       ║
║      ║             ║        ║           ║       ║
║      ║             ╚═══╗_╔══╝           ║       ║
║      ║                                  ║       ║
║      ║                                  ║       ║
╚══════╝                                  ╚═══════╝