*****************************************************************
*  ╔══════╗                ╔═╗                 ╔═╝-╚═╗          *
*  ║      ║                ║ ║                 ║     ║          *
*  ║      ║             ╔══╝ ╚═╗               ╚═╗  ╔╝          *
*  ╚═╗  ╔═╝ ╔══════════╗╚══╗ ╔═╝ ╔══════════╗  ╔═╝  ╚════════╗  *
*  ╔═╝  ╚═╗ ║          ╚═══╝ ╚═══╝          ╚══╝             ╚  *
*  ╝      ╚═╝                                                [  *
*  ]                   ╔╗       ╔╗          ╔═╗              ╔  *
*  ╗      ╔═╗          ║╚╗      ║╚══════════╝ ╚╗  ╔══════════╝  *
*  ╚═╗  ╔═╝ ╚══════════╝ ╚═╗  ╔═╝            ╔═╝  ╚══╗          *
*  ╔═╝  ╚═╗             ╔══╝  ╚══╗           ║       ║          *
*  ║      ║             ║        ║           ║       ║          *
*  ║      ║             ╚═══╗_╔══╝           ║       ║          *
*  ║      ║                                  ║       ║          *
*  ║      ║                                  ║       ║          *
*  ╚══════╝                                  ╚═══════╝          *
*****************************************************************